1111111111
1010000101
1010101101
1000100001
1111111111